name: test.txt
background: resources/images/backgrounds/forest_background.png
midground: resources/images/backgrounds/forest_midground.png
foreground: resources/images/backgrounds/forest_foreground.png
background_music: resources/sounds/jungle_synthetic.wav
overlay: resources/images/night_filter.png
next_level: forest_2
level_data:
  ....................................................................................................................................................
  ....................................................................................................................................................
  ....................................................................................................................................................
  ....................................................................................................................................................
  ....................................................................................................................................................
  ....................................................................................................................................................
  ....................................................................................................................................................
  ....................................................................................................................................................
  ....................................................................................................................................................
  ............................................................................................................................00000000................
  ............................................................................................................................0000000.................
  ..............................................................................................................................0000..................
  ...............................................................................................................................R....................
  ...............................................................................................................................R....................
  .......................................................................................0000....................................R....................
  .....................................................0000000000000...0000....00000......00....000000000....0000................R....................
  ......................................................00000000000.....00......000...............000000......0000...............R....................
  ........................................................00000000...............0..................000..............00000000....R....................
  .........................................................0000........................................................00000.....R....................
  ......................................................................................................................000......R....................
  .......................................................................................................................R.......R....................
  .......................................................................................................................R.......R....................
  .......................................................................................................................R............................
  .......................................................................................................................R...0000.....................
  .......................................................................................................................R.0000000....................
  .......................................................................................................................R..0000......................
  .......................................................................................................................R....R.......................
  .......................................................................................................................R....R.......................
  .......................................................................................................................R....R.......................
  .......................................................................................................................R....R.......................
  .......................................................................................................................R....R.......................
  .......................................................................................................................R....R.......................
  ............................................................................................................................R.......................
  ............................................................................................................................R.......................
  .................................0000000......................................................................................000...................
  .................................0000000000....................................................................................0000...0000..........
  ....................................000000R.....................................................................................00......00..........
  ..........................................R.................................................................................................L0000...
  ..........................................R..............0000000000000000000000.............................................................L.00....
  ..........................................R........000000000000000000000000000000000000.....................................................L.......
  ..........................................R....0000000000000000000000000000000000000000000..................................................L.......
  ..........................................R....000000000000000000000000000000000000000000000000..00000..0000000...0000.........0000000000000000.....
  ..........................................R.....00000000000000000000000000000000000000000000000...000.....0000.....00...0000.....00000000000000.....
  ..........................................R..........0000000000000000000000000R..........................................00........000000000........
  ..........................................R...............................R...R......................................................0000...........
  ..........................................R...............................R...R.....................................................................
  ..........................................................................R...R.....................................................................
  ..............................................................000.........R...R.....................................................................
  .......................................00000000000000000000000000000000000R...R.....................................................................
  ........................................000000000000000000000000000000000.R...R.....................................................................
  ............................................000000000000000000000000......R...R.....................................................................
  .....................................................000000...............R...R.....................................................................
  ..........................................................................R...R.....................................................................
  ..............................................................................R.....................................................................
  ..............................................................................R.....................................................................
  ....................................................................................................................................................
  ................................................................................00..................................................................
  .................................................................................0..0...............................................................
  ....................................................................................00..............................................................
  ..........................................................L.........................000.............................................................
  ..........................................................L00000000000000000...00000000.............................................................
  ..........................................................L.00000000000000.......00000..............................................................
  ..........................................................L...0000000000............................................................................
  ..........................................................L.........................................................................................
  ..........................................................L.........................................................................................
  ...............................P............0000L..00000000.........................................................................................
  .......................................000000000L..000000000000.....................................................................................
  ......................................0000000000L..0000000000000000.................................................................................
  .............................0000000000000000000L.....00000000000000000000000000....................................................................
  .............................0000000000000000000L.......000000000000000000000000000.................................................................
  ............................000000000000000000000000.......0000000000000000000000000................................................................
  ............................00000000000000000000000000...........0000000000000000000................................................................
  ............................0000000000000000000000000000...........000000000000000000...............................................................
  ...........................0000000000000000000000000000000........0000000000000000000...............................................................
  ...........................0000000000000000000000000000000000000000000000000000000000...............................................................
  WWWWWWWWWWWWWWWWWWWWWWWWWWW0000000000000000000000000000000000000000000000000000000000WWWWWWWWWWWWWWWWWWWWWWWWWWWWWWWWWWWWWWWWWWWWWWWWWWWWWWWWWWWWWWW
  MMMMMMMMMMMMMMMMMMMMMMMMMMM0000000000000000000000000000000000000000000000000000000000MMMMMMMMMMMMMMMMMMMMMMMMMMMMMMMMMMMMMMMMMMMMMMMMMMMMMMMMMMMMMMM
  MMMMMMMMMMMMMMMMMMMMMMMMMMM0000000000000000000000000000000000000000000000000000000000MMMMMMMMMMMMMMMMMMMMMMMMMMMMMMMMMMMMMMMMMMMMMMMMMMMMMMMMMMMMMMM
keymap:
  0:FOREST_GROUND
  B:BARRIER
  R:ROPE
  W:WATER_TOP
  L:LADDER
  l:LAVA
  M:WATER_BOTTOM
  .:VOID
  @:TREE_WILLOW_1
  !:TREE_WILLOW_0
  #:TREE_WILLOW_2
  $:FOREST_PLANT_0
  %:FOREST_PLANT_1
  F:HANGING_VINE_FLOWERS
  &:MUSHROOM
  *:MUSHROOM_BLUE
  +:FIREFLIES
  Q:OLD_BRICK_WALL
  r:ROCK
  T:TALL_GRASS
  U:BUSH
  V:HANGING_VINE
  Z:LAMP_POST
  ^:ROCK_LARGE
  ~:FOG
  P:PLAYER_SPAWN
  C:GOLD_COIN
  D:DOOR
  E:PLANT_MONSTER
  H:HEART
  K:KEY