name: Demo
background: resources/images/background.jpg
neBt_level: level_demo_2
level_width: 30
level_height: 30
level_data:
  [BBBBBBBBBBBBBBBBBBBBBBBBBBBBBB]
  [B............................B]
  [B............................B]
  [B............................B]
  [B............................B]
  [B............................B]
  [B............................B]
  [B.............B.B............B]
  [B............................B]
  [B............................B]
  [B............................B]
  [B............................B]
  [B............................B]
  [B............................B]
  [B............................B]
  [B............................B]
  [B............................B]
  [B............................B]
  [B.................L..........B]
  [B.................L..........B]
  [B.................L..........B]
  [B.........L....K.............B]
  [B.........L...GGG............B]
  [B.........LGGGGGGGG..........B]
  [B.........L..................B]
  [B.........L..................B]
  [B.........L..................B]
  [B....P....L...........E...D..B]
  [XXXXXXXXXXXXXXXXXXXXXXXXXXXXXX]
  [XXXXXXXXXXXXXXXXXXXXXXXXXXXXXX]
